01111111110
100100000E1
10C10111001
10110101101
10P00101001
10111100C11
10000001111
01111111110
