1111111111
00100000E1
0C10111001
0110101101
0P00101001
0111100C11
0000001111
1111111111
