11111111111
10010000001
10C10111001
10110101101
10P00101001
10111100C11
10000001111
11111111111
