11111111111
100100000E1
10C10111001
10010101101
10P00101001
10111100C11
10000001111
11111111111
