1111111111111111111111
10010000000000000000E1
10C1011100001000000001
1011010110001000M00001
10P0010100001000000001
1011110000001000000C11
1000000000001000001111
1001010001111000000001
10M1010001C01000111111
10010100010010001C0001
1001010001101000100001
1001011000001000100001
1001C1C001111000111001
1001110000001000000001
1001C11111111000M00001
1000000000000000000001
1111111111111111111111
