1111111111
1P1000M0E1
101000M001
110000M0C1
1111111111
