1111111111
10100C0001
1P1000M0E1
100000M001
110000M0C1
1000000001
1111111111
