1111111111111111111111
1P000000C0000M000000E1
1111111111111111111111
